R  1000 1000
NO ./texture/1375SO.xpm
SO ./texture/1375NO.xpm
WE ./texture/1375WE.xpm
EA ./texture/1375EA.xpm
S ./texture/sprite2.xpm
F 115,115,115
C 37,44,88

         1111111111111111111111
    111111000000000110000000000111
    11111100000000030000000000111
    11111101100000111000002000011
1111111111110010000100000020000001111
111111111011000001110000000000111111111111111111111111111111
10000000000000000100000000N000000000000000000000000000000001
1111011111111101110000001000111111111111111111111111111111111
1111011111111101110101001000111
1100000011010101110000001000111
1000000000000000110000001000111
1000000000000000110101001000111
1111111111111111111111111111111