R  1000 1000
NO ./texture/logo1.xpm
SO ./texture/logo2.xpm
WE ./texture/logo3.xpm
EA ./texture/logo4.XPM
S texture/sprite.xpm
F 115,120,150
C 37,44,88

111111111111111111111111111111111111111111111111111111111111111111111111111111111111111111111111111111111111111111
100000111111111                                                                                                  1
1111100000000001                                                                                                  1
1000020003330001                                                                                                 1
10000N0001110001    1                                                                                             1
1000000001110001   101             1111111    111111    1111111   1111111    11    11                            1
1111111111111111    1              1     1    1     1   1     1   1     1    11    11                             1
1                                   1111111    1111111   1111111   1111111    11111111                           1
11111                              1     1    1         1     1   1     1    11    11                             1
10001   111111111111111111111      1     1    1         1     1   1     1    11    11                            1
10001   100000000000000000001                                                                                     1
10001   100000000000000020001                                                                                    1
11111   100000000000000000001                                                                                     1
10001   111111111111111111111                                                                                    1
11011                                                                                                             1
111111111111111111111111111111111111111111111111111111111111111111111111111111111111111111111111111111111111111111