R 1000 1000
NO ./texture/logo1.xpm
SO ./texture/logo2.xpm
WE ./texture/logo3.xpm
EA ./texture/logo4.XPM
S   texture/sprite 2.xpm



F 115,120,150
C 137,144,188



        111111111111111111111111
        1000000000110000000000001
        101100000111022222200N001
        1001000000000222222000001
111111111011000001110222222000001
100000000011000001110111111111111
11110111111111011100000010001
11110111111111011101010010001
11000000110101011100000010001
10002000000000001100000010101
10000000000000001101010010201
1100000111010101111101111000111
11110111 1110101 101111010001
11111111 1111111 111111111111