R  1000 1000
NO ./logo1.xpm
SO ./logo2.xpm
WE ./logo3.xpm
EA ./logo4.xpm
S ./sprite.xpm
F 115,115,115
C 37,44,88

111111111111111111111111111111111
    111111000000000110000000000111
    111111000000000100000000000111
    111111011000001110000020000111
1111111111110010000000000000000001111
111131111011000001110000000000111
1000N0000110000011101111101111
1111011111111101110000001000111
1111011111111101110101001000111
1100000011010101110000001000111
1000000000000000110000001000111
1000000000000000110101001000111
1111111111111111111111111111111
k