R  1000 1000
NO ./1375NO.xpm
SO ./1375SO.xpm
WE ./1375WE.xpm
EA ./1375EA.xpm
S ./sprite.xpm
F 115,115,115
C 37,44,88

111111111111111111111111111111111
    111111000000000110000000000111
    111111000000000110000000000111
    111111011000001110000020000111
1111111111110010000000000000000001111
111111111011000001110000000000111
1000000000110000011101111101111
1111011111111101110000001000111
1111011111111101110101001000111
1100000011010101110000001000111
10000000000000001100000010N0111
1000000000000000110101001000111
1111111111111111111111111111111