R 2000 2000
NO ./path_to_the_north_texture
SO ./path_to_the_south_texture
WE ./path_to_the_west_texture
EA ./path_to_the_east_texture
S ./path_to_the_sprite_texture
F 255,200,50
C 255,30,50

111111111111111111111111111111111
   111111000000000110000000000111
   111111011000001110000000000111
1111111111110010000000000000000001111
111111111011000001110000000000111
1000000000110000011101111101111
1111011111111101110000001000111
1111011111111101110101001000111
1100000011010101110000001000111
10002000000000001100000010N0111
1000000000000000110101001000111
1111111111111111111111111111111