R  2000 2000
NO ./texture/logo1.xpm
SO ./texture/logo2.xpm
WE ./texture/logo3.xpm
EA ./texture/logo4.xpm
S ./texture/sprite2.xpm
F 115,115,115
C 37,44,88

         1111111111111111111111
    111111000000000110000000000111
    11111100000000030000000000111
    11111101100000111000002000011
1111111111110010000100000020000001111
111111111011000001110000002000111111111111111111111111111111
10000000000000000100000002N200000000000000000000000000000001
1111011111111101110000001020111111111111111111111111111111111
1111011111111101110101001000111
1100000011010101110000001000111
1000000000000000110000001000111
1000000000000000110101001000111
1111111111111111111111111111111